0 0 0 0 0 0 0 0 0 0 0 0 0 0 0 0 0 0 0 0 0 0 0 0 0 0 0 0 0 0
0 0 0 0 0 0 0 0 0 0 0 0 0 0 0 0 0 0 0 0 0 0 0 0 0 0 0 0 0 0
0 0 0 0 0 0 0 0 0 0 0 0 0 0 0 0 0 0 0 0 0 0 0 0 0 0 0 0 0 0
0 ( - - - - - - - - - - - - ) ( - - - - - - - - - - - - ) 0
0 { * * * * * * * * * * * * 0 0 * * * * * * * * * * * * } 0
0 { * 0 0 0 0 * 0 0 0 0 0 * 0 0 * 0 0 0 0 0 * 0 0 0 0 * } 0
0 { + 0 0 0 0 * 0 0 0 0 0 * 0 0 * 0 0 0 0 0 * 0 0 0 0 + } 0
0 { * 0 0 0 0 * 0 0 0 0 0 * 0 0 * 0 0 0 0 0 * 0 0 0 0 * } 0
0 { * * * * * * * * * * * * * * * * * * * * * * * * * * } 0
0 { * 0 0 0 0 * 0 0 * 0 0 0 0 0 0 0 0 * 0 0 * 0 0 0 0 * } 0
0 { * 0 0 0 0 * 0 0 * 0 0 0 0 0 0 0 0 * 0 0 * 0 0 0 0 * } 0
0 { * * * * * * 0 0 * * * * 0 0 * * * * 0 0 * * * * * * } 0
0 [ _ _ _ _ .) * 0 0 0 0 0 0 0 0 0 0 0 0 0 0 * .( _ _ _ _ ] 0
0 0 0 0 0 0 { * 0 0 0 0 0 0 0 0 0 0 0 0 0 0 * } 0 0 0 0 0 0
0 0 0 0 0 0 { * 0 0 0 0 0 0 0 0 0 0 0 0 0 0 * } 0 0 0 0 0 0
0 0 0 0 0 0 { * 0 0 0 0 0 0 0 0 0 0 0 0 0 0 * } 0 0 0 0 0 0
- - - - - - .] * 0 0 0 0 0 0 0 0 0 0 0 0 0 0 * .[ - - - - - -
= 0 0 0 0 0 0 * 0 0 0 0 0 0 0 0 0 0 0 0 0 0 * 0 0 0 0 0 0 =
_ _ _ _ _ _ .) * 0 0 0 0 0 0 0 0 0 0 0 0 0 0 * .( _ _ _ _ _ _
0 0 0 0 0 0 { * 0 0 0 0 0 0 0 0 0 0 0 0 0 0 * } 0 0 0 0 0 0
0 0 0 0 0 0 { * 0 0 0 0 0 0 0 0 0 0 0 0 0 0 * } 0 0 0 0 0 0
0 0 0 0 0 0 { * 0 0 0 0 0 0 0 0 0 0 0 0 0 0 * } 0 0 0 0 0 0
0 ( - - - - .] * 0 0 0 0 0 0 0 0 0 0 0 0 0 0 * .[ - - - - ) 0
0 { * * * * * * * * * * * * 0 0 * * * * * * * * * * * * } 0
0 { * 0 0 0 0 * 0 0 0 0 0 * 0 0 * 0 0 0 0 0 * 0 0 0 0 * } 0
0 { * 0 0 0 0 * 0 0 0 0 0 * 0 0 * 0 0 0 0 0 * 0 0 0 0 * } 0
0 { + * * 0 0 * * * * * * * P P * * * * * * * 0 0 * * + } 0
0 { 0 0 * 0 0 * 0 0 * 0 0 0 0 0 0 0 0 * 0 0 * 0 0 * 0 0 } 0
0 { 0 0 * 0 0 * 0 0 * 0 0 0 0 0 0 0 0 * 0 0 * 0 0 * 0 0 } 0
0 { * * * * * * 0 0 * * * * 0 0 * * * * 0 0 * * * * * * } 0
0 { * 0 0 0 0 0 0 0 0 0 0 * 0 0 * 0 0 0 0 0 0 0 0 0 0 * } 0
0 { * 0 0 0 0 0 0 0 0 0 0 * 0 0 * 0 0 0 0 0 0 0 0 0 0 * } 0
0 { * * * * * * * * * * * * * * * * * * * * * * * * * * } 0
0 [ _ _ _ _ _ _ _ _ _ _ _ _ _ _ _ _ _ _ _ _ _ _ _ _ _ _ ] 0
0 0 0 0 0 0 0 0 0 0 0 0 0 0 0 0 0 0 0 0 0 0 0 0 0 0 0 0 0 0
0 0 0 0 0 0 0 0 0 0 0 0 0 0 0 0 0 0 0 0 0 0 0 0 0 0 0 0 0 0